      W       W
 WWWWWW WWWWW W
 W          W W
 W WWWWWWWW W W
   W      W W W
 WWW      W W W
 W W      W W W
 WHW      W W W
 W W      W W W
 W W WWWW W W W
 W W WWWW W W W
 W      W W W W
 WWWWWWWW   W W
M           W W
WWWWWWWWWWWWWWW