WWWWWWWWWW
w        W
W        W
W        W
W WWMWWW W
W        W
W W WW W W
W        W
WH       W
WWWWWWWWWW